0000000110000000000000100100000000001010
0011000100000000010000001000000000000001
1100000100000100000000001000011000001001
1000100000100100101100010010100100010000
0001100000001000010010000110000001000001
0000000000000001101001000001100010001100
0000010000010000010101000001011001010000
1000100001000100010000000000001000000100
0010000000100000010100000010001000100100
0000000010101100000100000001100101100100
0000000100001000000000011001011100100000
0101000000000001100000000000000010010100
0100100000010000001101001000001000000011
0000011000000001010000100000000000100000
0001000001001000110010000000000000000000
0000000110001000000000110010000000000100
0000000001000000000010100000101000010100
0000010000000100000010000101000000001011
0000001000000101000100010000000010001010
0000110000000010000000001010101000100100
0001000000000000000000001000000000000111
0001000101010010000000010010000100000000
1001000000000011001100010101000000000010
1000010000000000000010100000000100000000
0000000000001110000001100011111000001011
0100000000010011010000010000000000010000
0100000000100100000001010000010000000110
1100000100000001000001001101000000000000
0000001100111000001000001110000100000000
0010100101101001000001000000001000000000
0000100001010000110001110000000000000000
0000010011000110000000000000011010100000
1100000000000000000000001000110111110100
0000100000000100001000000110110000000111
0000000000000000000000011010000001000000
1000001000000000100000000000000000000010
0001000000001000001000011100000011000000
1001000011101000100000101001000001100100
0100000000110000010000001000001001010000
0000000010000100000001000011000001010100
