01110000000001100100000000000000000100100011000000
00001010000000000010000000110100110000000100010101
01001000010001000000100000001001110010000101100100
00101010010011000100100001100000101000000011001000
00011010000001111010100110011101101000000101011010
00000101001100001101110011110100110001110001100000
01110101101000001001100100110000101000010100010010
00000100000101010000110000001000110001000010110111
00000000100000001000000100000010100010100100010010
11101010100110000100000011000010100010010100100101
00100100000010000100000010101111001100000010111011
00100010011010000100000000001100000100000010110101
11010010111000001000111010000010101000010010100011
10000000110000010011000010000101001100000000000001
01001001100100000000000000100000001111010100110100
10000000001011001001101000100101100101001110011001
01000101000100000001000110001100000100001001001010
00010000000001110000110101001010000111000000000100
00000001000100101000000000010011000100001001100100
00001000101111011000000010101000001111001000010011
00001001000110000000001000000001011000101011010100
00100100101000001001000010000010100100001001010101
01111000101010000100010000010000100001000000010011
00111000000000010000000000111010100000000000001010
00000011000000110011010011101110100000100001100100
10001001101100000000011001001000010110110001000101
10000001001011000001000000001000000000010110010100
11100010010110010010001010000100111100010110101100
00000000111000010110000000000011100000110000000000
10100100010111000100001011010010100101000000100001
00000100000000000100001010100010111000100000000000
00000000011110100000001100010011000000000000011101
00010100101111011100001001000000010101000000100000
00101001010100010100100000101110011100001000010010
00011000100111001000111100101100000000110101001100
10000011100001100100001010000000000010000110001001
00000000000100010000000000011100101000110000010000
10110010000000011101011111111000101000011001100111
00000110010111000010001001010101100000000000000001
11001110100111101110101000100100110010100000010010
00111110100000101011000001000001000000011100000000
00010011100000100000010110100001010100000000011001
00000101010111101100010000010001100000010000100000
01000000000111000110000000001001100011010000100001
10000000000010101101011010000010100000001000000010
01001001110000000000000011110000010000011110010111
10011010110010010011100100110000000000100101000010
00010001100110010100001100000001111000001110000000
00001010100110100000011110001111110001001000011000
00110100000001000101010000110010010000010100000000
