00000000000000000000
00100000000000000000
00100011100000000110
00000011100000000110
00000011100000000000
01110000000000011110
01110000000111011110
00000000000111011110
01110000000111000000
00000000000111000000
00000011101111000000
00000011100111000000
00000000000111011110
00000000000000000000
01110000001011111000
01110011101000000000
00000011101000110110
00000000000000110110
00000000000000000000
00000000000000000000
