000000011100000110000001110001
001111011000000100100001100001
001111011000000000000001100000
000110010001100000000001000000
110000000001000000000110000000
110000000001001111000110000011
111000110000001111100111000011
011001110110000011100011011000
001001110110001111101001011011
000000110000000000100001000000
000000000000000000001000000000
000000000101000000010000010000
000010100101001011010000010010
110010100111001011010110011010
010011100000000011110010000000
110000000000000000001110000000
000100000110010000000000011100
001100010110011000000001011110
001000110000001111000001000011
001010111100000001000001110000
000100011000001111000001100011
000000000000000001111000000000
000001101001100001000000100000
000001100001100001000000000000
110001101101110000001110110100
000000011100011110000001110111
110010010000000001111111000000
000000111001100001001001100000
000011110001100001000001000000
001110000110010001001000011100
